##############################
#                            #
#        -------------       #
#                            #
#      -----            -----#
#                            #
#----         -------        #
#                        ----#
#    -----                   #
#                            #
#             ------         #
#                            #
#    -----            ---    #
#                            #
#            ------          #
#-----                       #
#                            #
#                            #
#                            #
##############################