##############################
#                            #
#                            #
#                            #
#                            #
#                            #
#                            #
#                            #
#                            #
#                            #
#                            #
# --------------             #
#                            #
#                            #
#                            #
#           -----------      #
#                            #
#                            #
#                            #
#                            #
##############################
