##############################
#                            #
#                            #
#                            #
#       -----                #
#                            #
#            --------------  #
#                            #
#                            #
#                            #
#                            #
# --------------             #
#                            #
#                            #
#                            #
#           -----------      #
#                            #
#                            #
#                            #
#                            #
##############################
